date,administered_doses_pfizer,administered_doses_moderna,administered_doses_astrazeneca,administered_doses_jj,einrichtung,delivered_doses_pfizer,delivered_doses_moderna,delivered_doses_astrazeneca,delivered_doses_jj,cum_administered_doses_pfizer,cum_administered_doses_moderna,cum_administered_doses_astrazeneca,cum_administered_doses_jj,cum_delivered_doses_pfizer,cum_delivered_doses_moderna,cum_delivered_doses_astrazeneca,cum_delivered_doses_jj
2020-12-26,0,0,0,0,impfzentren,151125,0,0,0,0,0,0,0,151125,0,0,0
2020-12-27,24360,7,1,0,NA,0,0,0,0,24360,7,1,0,151125,0,0,0
2020-12-28,18111,1,0,0,impfzentren,521625,0,0,0,42471,8,1,0,672750,0,0,0
2020-12-29,50735,0,1,0,NA,0,0,0,0,93206,8,2,0,672750,0,0,0
2020-12-30,64138,0,0,0,impfzentren,653250,0,0,0,157344,8,2,0,1326000,0,0,0
2020-12-31,50017,0,1,0,NA,0,0,0,0,207361,8,3,0,1326000,0,0,0
2021-01-01,25573,16,5,0,NA,0,0,0,0,232934,24,8,0,1326000,0,0,0
2021-01-02,48092,1,0,0,NA,0,0,0,0,281026,25,8,0,1326000,0,0,0
2021-01-03,22563,3,0,0,NA,0,0,0,0,303589,28,8,0,1326000,0,0,0
2021-01-04,46166,11,0,0,NA,0,0,0,0,349755,39,8,0,1326000,0,0,0
2021-01-05,52707,1,0,0,NA,0,0,0,0,402462,40,8,0,1326000,0,0,0
2021-01-06,63162,7,3,0,NA,0,0,0,0,465624,47,11,0,1326000,0,0,0
2021-01-07,54804,7,2,0,NA,0,0,0,0,520428,54,13,0,1326000,0,0,0
2021-01-08,62789,51,3,0,impfzentren,687375,0,0,0,583217,105,16,0,2013375,0,0,0
2021-01-09,60741,4,1,0,NA,0,0,0,0,643958,109,17,0,2013375,0,0,0
2021-01-10,35987,11,1,0,NA,0,0,0,0,679945,120,18,0,2013375,0,0,0
2021-01-11,68280,16,2,0,NA,0,0,0,0,748225,136,20,0,2013375,0,0,0
2021-01-12,79134,18,4,0,impfzentren,0,63600,0,0,827359,154,24,0,2013375,63600,0,0
2021-01-13,111029,1180,0,0,NA,0,0,0,0,938388,1334,24,0,2013375,63600,0,0
2021-01-14,78971,5164,1,0,NA,0,0,0,0,1017359,6498,25,0,2013375,63600,0,0
2021-01-15,86513,5285,19,0,NA,0,0,0,0,1103872,11783,44,0,2013375,63600,0,0
2021-01-16,56397,1694,1,0,NA,0,0,0,0,1160269,13477,45,0,2013375,63600,0,0
2021-01-17,46555,1262,1,0,NA,0,0,0,0,1206824,14739,46,0,2013375,63600,0,0
2021-01-18,78751,4264,2,0,NA,0,0,0,0,1285575,19003,48,0,2013375,63600,0,0
2021-01-19,115892,3767,51,0,impfzentren,842400,0,0,0,1401467,22770,99,0,2855775,63600,0,0
2021-01-20,129944,2841,4,0,NA,0,0,0,0,1531411,25611,103,0,2855775,63600,0,0
2021-01-21,102734,2820,2,0,NA,0,0,0,0,1634145,28431,105,0,2855775,63600,0,0
2021-01-22,100142,2196,14,0,NA,0,0,0,0,1734287,30627,119,0,2855775,63600,0,0
2021-01-23,86705,359,5,0,NA,0,0,0,0,1820992,30986,124,0,2855775,63600,0,0
2021-01-24,47620,201,4,0,NA,0,0,0,0,1868612,31187,128,0,2855775,63600,0,0
2021-01-25,89578,1456,3,0,NA,0,0,0,0,1958190,32643,131,0,2855775,63600,0,0
2021-01-26,96973,1442,7,0,impfzentren,489060,0,0,0,2055163,34085,138,0,3344835,63600,0,0
2021-01-27,107637,1793,8,0,NA,0,0,0,0,2162800,35878,146,0,3344835,63600,0,0
2021-01-28,90924,1632,3,0,NA,0,0,0,0,2253724,37510,149,0,3344835,63600,0,0
2021-01-29,106202,1485,71,0,NA,0,0,0,0,2359926,38995,220,0,3344835,63600,0,0
2021-01-30,87242,884,3,0,NA,0,0,0,0,2447168,39879,223,0,3344835,63600,0,0
2021-01-31,56849,381,5,0,impfzentren,0,90000,0,0,2504017,40260,228,0,3344835,153600,0,0
2021-02-01,117946,2224,55,0,NA,0,0,0,0,2621963,42484,283,0,3344835,153600,0,0
2021-02-02,129695,3141,23,0,impfzentren,747630,0,0,0,2751658,45625,306,0,4092465,153600,0,0
2021-02-03,156591,6401,27,0,NA,0,0,0,0,2908249,52026,333,0,4092465,153600,0,0
2021-02-04,128687,5901,8,0,NA,0,0,0,0,3036936,57927,341,0,4092465,153600,0,0
2021-02-05,141112,6475,9,0,NA,0,0,0,0,3178048,64402,350,0,4092465,153600,0,0
2021-02-06,91581,2637,1,0,impfzentren,0,0,345600,0,3269629,67039,351,0,4092465,153600,345600,0
2021-02-07,51243,2340,2,0,NA,0,0,0,0,3320872,69379,353,0,4092465,153600,345600,0
2021-02-08,105639,3838,30,0,NA,0,0,0,0,3426511,73217,383,0,4092465,153600,345600,0
2021-02-09,130994,3447,187,0,impfzentren,747630,0,0,0,3557505,76664,570,0,4840095,153600,345600,0
2021-02-10,142861,4297,8397,0,NA,0,0,0,0,3700366,80961,8967,0,4840095,153600,345600,0
2021-02-11,120871,7321,16399,0,NA,0,0,0,0,3821237,88282,25366,0,4840095,153600,345600,0
2021-02-12,132454,9384,14413,0,impfzentren,0,0,391200,0,3953691,97666,39779,0,4840095,153600,736800,0
2021-02-13,91193,3274,13416,0,NA,0,0,0,0,4044884,100940,53195,0,4840095,153600,736800,0
2021-02-14,55691,2485,7302,0,NA,0,0,0,0,4100575,103425,60497,0,4840095,153600,736800,0
2021-02-15,104985,5327,15554,0,impfzentren,0,182400,0,0,4205560,108752,76051,0,4840095,336000,736800,0
2021-02-16,108932,6217,19707,0,impfzentren,904410,0,0,0,4314492,114969,95758,0,5744505,336000,736800,0
2021-02-17,122856,8064,20972,0,NA,0,0,0,0,4437348,123033,116730,0,5744505,336000,736800,0
2021-02-18,112648,8291,23961,0,NA,0,0,0,0,4549996,131324,140691,0,5744505,336000,736800,0
2021-02-19,121402,10047,27660,0,impfzentren,0,0,715200,0,4671398,141371,168351,0,5744505,336000,1452000,0
2021-02-20,86713,4483,21355,0,NA,0,0,0,0,4758111,145854,189706,0,5744505,336000,1452000,0
2021-02-21,66568,3650,15813,0,NA,0,0,0,0,4824679,149504,205519,0,5744505,336000,1452000,0
2021-02-22,123624,9080,23998,0,NA,0,0,0,0,4948303,158584,229517,0,5744505,336000,1452000,0
2021-02-23,134347,7367,28909,0,impfzentren,926640,0,0,0,5082650,165951,258426,0,6671145,336000,1452000,0
2021-02-24,132138,7663,37299,0,NA,0,0,0,0,5214788,173614,295725,0,6671145,336000,1452000,0
2021-02-25,131985,6795,51559,0,NA,0,0,0,0,5346773,180409,347284,0,6671145,336000,1452000,0
2021-02-26,141947,8887,63275,0,NA,0,0,0,0,5488720,189296,410559,0,6671145,336000,1452000,0
2021-02-27,92777,4091,51264,0,impfzentren,0,342900,0,0,5581497,193387,461823,0,6671145,678900,1452000,0
2021-02-28,61669,3968,37887,0,NA,0,0,0,0,5643166,197355,499710,0,6671145,678900,1452000,0
2021-03-01,131099,9718,58625,0,NA,0,0,0,0,5774265,207073,558335,0,6671145,678900,1452000,0
2021-03-02,140945,10119,69153,0,impfzentren,1014390,0,650400,0,5915210,217192,627488,0,7685535,678900,2102400,0
2021-03-03,158653,15189,74749,0,NA,0,0,0,0,6073863,232381,702237,0,7685535,678900,2102400,0
2021-03-04,141993,14523,89456,0,NA,0,0,0,0,6215856,246904,791693,0,7685535,678900,2102400,0
2021-03-05,148540,13400,113742,0,NA,0,0,0,0,6364396,260304,905435,0,7685535,678900,2102400,0
2021-03-06,109470,8869,84555,0,NA,0,0,0,0,6473866,269173,989990,0,7685535,678900,2102400,0
2021-03-07,79893,6690,61326,0,NA,0,0,0,0,6553759,275863,1051316,0,7685535,678900,2102400,0
2021-03-08,134451,10990,92896,0,NA,0,0,0,0,6688210,286853,1144212,0,7685535,678900,2102400,0
2021-03-09,140578,12809,99679,0,impfzentren,1083420,0,960000,0,6828788,299662,1243891,0,8768955,678900,3062400,0
2021-03-10,159905,12262,117842,0,NA,0,0,0,0,6988693,311924,1361733,0,8768955,678900,3062400,0
2021-03-11,148015,13783,123416,0,NA,0,0,0,0,7136708,325707,1485149,0,8768955,678900,3062400,0
2021-03-12,151909,17339,158498,0,NA,0,0,0,0,7288617,343046,1643647,0,8768955,678900,3062400,0
2021-03-13,116331,9598,115395,0,NA,0,0,0,0,7404948,352644,1759042,0,8768955,678900,3062400,0
2021-03-14,88267,5523,76681,0,NA,0,0,0,0,7493215,358167,1835723,0,8768955,678900,3062400,0
2021-03-15,153292,12759,82944,0,impfzentren,0,0,364800,0,7646507,370926,1918667,0,8768955,678900,3427200,0
2021-03-16,167032,11314,1201,0,impfzentren,1083420,0,0,0,7813539,382240,1919868,0,9852375,678900,3427200,0
2021-03-17,187080,18066,755,0,NA,0,0,0,0,8000619,400306,1920623,0,9852375,678900,3427200,0
2021-03-18,174675,18233,1171,0,NA,0,0,0,0,8175294,418539,1921794,0,9852375,678900,3427200,0
2021-03-19,186321,20880,38734,0,NA,0,0,0,0,8361615,439419,1960528,0,9852375,678900,3427200,0
2021-03-20,135689,15356,69849,0,NA,0,0,0,0,8497304,454775,2030377,0,9852375,678900,3427200,0
2021-03-21,102470,9214,53258,0,impfzentren,0,432000,0,0,8599774,463989,2083635,0,9852375,1110900,3427200,0
2021-03-22,166950,23885,79170,0,NA,0,0,0,0,8766724,487874,2162805,0,9852375,1110900,3427200,0
2021-03-23,182228,19785,99746,0,impfzentren,1076400,0,204000,0,8948952,507659,2262551,0,10928775,1110900,3631200,0
2021-03-24,200977,33200,106285,0,NA,0,0,0,0,9149929,540859,2368836,0,10928775,1110900,3631200,0
2021-03-25,186471,27726,119799,0,NA,0,0,0,0,9336400,568585,2488635,0,10928775,1110900,3631200,0
2021-03-26,200537,37368,137598,0,impfzentren,0,0,201600,0,9536937,605953,2626233,0,10928775,1110900,3832800,0
2021-03-27,149884,27720,104364,0,NA,0,0,0,0,9686821,633673,2730597,0,10928775,1110900,3832800,0
2021-03-28,115541,18565,62687,0,NA,0,0,0,0,9802362,652238,2793284,0,10928775,1110900,3832800,0
2021-03-29,189247,25035,92271,0,NA,0,0,0,0,9991609,677273,2885555,0,10928775,1110900,3832800,0
2021-03-30,219264,24534,86216,0,impfzentren,1427400,0,0,0,10210873,701807,2971771,0,12356175,1110900,3832800,0
2021-03-31,248783,36248,52822,0,NA,0,0,0,0,10459656,738055,3024593,0,12356175,1110900,3832800,0
2021-04-01,240537,32536,55495,0,NA,0,0,0,0,10700193,770591,3080088,0,12356175,1110900,3832800,0
2021-04-02,179948,14424,31888,0,impfzentren,0,650400,0,0,10880141,785015,3111976,0,12356175,1761300,3832800,0
2021-04-03,174657,15855,42036,0,impfzentren,0,0,1744800,0,11054798,800870,3154012,0,12356175,1761300,5577600,0
2021-04-04,132577,10088,50813,0,NA,0,0,0,0,11187375,810958,3204825,0,12356175,1761300,5577600,0
2021-04-05,165413,17898,65192,0,NA,0,0,0,0,11352788,828856,3270017,0,12356175,1761300,5577600,0
2021-04-06,255436,32252,86793,0,NA,0,0,0,0,11608224,861108,3356810,0,12356175,1761300,5577600,0
2021-04-07,543459,37142,89161,0,impfzentren,2737734,0,0,0,12151683,898250,3445971,0,15093909,1761300,5577600,0
2021-04-07,543459,37142,89161,0,arztpraxen,2737734,0,0,0,12695142,935392,3535132,0,17831643,1761300,5577600,0
2021-04-08,573066,35719,91944,0,NA,0,0,0,0,13268208,971111,3627076,0,17831643,1761300,5577600,0
2021-04-09,491949,36764,105385,0,NA,0,0,0,0,13760157,1007875,3732461,0,17831643,1761300,5577600,0
2021-04-10,248801,23277,101091,0,NA,0,0,0,0,14008958,1031152,3833552,0,17831643,1761300,5577600,0
2021-04-11,170655,18700,75009,0,NA,0,0,0,0,14179613,1049852,3908561,0,17831643,1761300,5577600,0
2021-04-12,279264,29302,110958,0,impfzentren,0,0,360000,0,14458877,1079154,4019519,0,17831643,1761300,5937600,0
2021-04-13,433200,27359,117659,0,impfzentren,2519669,0,0,0,14892077,1106513,4137178,0,20351312,1761300,5937600,0
2021-04-13,433200,27359,117659,0,arztpraxen,2519669,0,0,0,15325277,1133872,4254837,0,22870981,1761300,5937600,0
2021-04-14,618594,33623,125294,0,NA,0,0,0,0,15943871,1167495,4380131,0,22870981,1761300,5937600,0
2021-04-15,536095,36273,110419,0,NA,0,0,0,0,16479966,1203768,4490550,0,22870981,1761300,5937600,0
2021-04-16,439926,32701,126223,0,NA,0,0,0,0,16919892,1236469,4616773,0,22870981,1761300,5937600,0
2021-04-17,225242,22732,118779,0,impfzentren,0,42000,0,0,17145134,1259201,4735552,0,22870981,1803300,5937600,0
2021-04-18,172304,15424,82264,0,bund,0,72000,57600,0,17317438,1274625,4817816,0,22870981,1875300,5995200,0
2021-04-19,294831,33023,75815,0,NA,0,0,0,0,17612269,1307648,4893631,0,22870981,1875300,5995200,0
2021-04-20,383385,39332,140124,0,impfzentren,2517024,0,0,0,17995654,1346980,5033755,0,25388005,1875300,5995200,0
2021-04-20,383385,39332,140124,0,arztpraxen,2517024,0,556930,0,18379039,1386312,5173879,0,27905029,1875300,6552130,0
2021-04-21,455892,41794,225672,0,impfzentren,0,477600,0,0,18834931,1428106,5399551,0,27905029,2352900,6552130,0
2021-04-22,383073,43733,213858,0,NA,0,0,0,0,19218004,1471839,5613409,0,27905029,2352900,6552130,0
2021-04-23,354284,43670,159916,0,NA,0,0,0,0,19572288,1515509,5773325,0,27905029,2352900,6552130,0
2021-04-24,235377,49440,81629,0,impfzentren,0,0,196800,0,19807665,1564949,5854954,0,27905029,2352900,6748930,0
2021-04-25,188056,33734,61723,0,impfzentren,0,388800,0,256800,19995721,1598683,5916677,0,27905029,2741700,6748930,256800
2021-04-25,188056,33734,61723,0,bund,21060,388800,9600,256800,20183777,1632417,5978400,0,27926089,3130500,6758530,513600
2021-04-26,318838,42576,72873,0,impfzentren,1364220,0,0,0,20502615,1674993,6051273,0,29290309,3130500,6758530,513600
2021-04-27,678588,51600,56988,0,arztpraxen,2049432,0,70,0,21181203,1726593,6108261,0,31339741,3130500,6758600,513600
2021-04-28,1010673,60835,53774,0,impfzentren,0,0,144000,0,22191876,1787428,6162035,0,31339741,3130500,6902600,513600
2021-04-29,826857,64026,57521,0,NA,0,0,0,0,23018733,1851454,6219556,0,31339741,3130500,6902600,513600
2021-04-30,680499,57410,67668,0,impfzentren,0,376800,60000,0,23699232,1908864,6287224,0,31339741,3507300,6962600,513600
2021-04-30,680499,57410,67668,0,bund,0,376800,0,0,24379731,1966274,6354892,0,31339741,3884100,6962600,513600
2021-05-01,253215,41573,39569,0,impfzentren,1825200,0,0,0,24632946,2007847,6394461,0,33164941,3884100,6962600,513600
2021-05-01,253215,41573,39569,0,bund,1825200,0,0,0,24886161,2049420,6434030,0,34990141,3884100,6962600,513600
2021-05-02,195857,37577,30168,0,NA,0,0,0,0,25082018,2086997,6464198,0,34990141,3884100,6962600,513600
2021-05-03,319025,70730,61861,0,impfzentren,0,0,60000,0,25401043,2157727,6526059,0,34990141,3884100,7022600,513600
2021-05-04,628166,63604,150466,0,arztpraxen,1535700,0,1100270,0,26029209,2221331,6676525,0,36525841,3884100,8122870,513600
2021-05-04,628166,63604,150466,0,impfzentren,0,0,0,216600,26657375,2284935,6826991,0,36525841,3884100,8122870,730200
2021-05-04,628166,63604,150466,0,bund,0,0,0,216600,27285541,2348539,6977457,0,36525841,3884100,8122870,946800
2021-05-05,853924,79146,212775,0,NA,0,0,0,0,28139465,2427685,7190232,0,36525841,3884100,8122870,946800
2021-05-06,695354,92299,201831,0,NA,0,0,0,0,28834819,2519984,7392063,0,36525841,3884100,8122870,946800
2021-05-07,589695,86802,213035,1,impfzentren,0,550800,0,0,29424514,2606786,7605098,1,36525841,4434900,8122870,946800
2021-05-07,589695,86802,213035,1,bund,0,550800,0,0,30014209,2693588,7818133,2,36525841,4985700,8122870,946800
2021-05-08,268108,71994,84736,0,impfzentren,1790100,0,0,0,30282317,2765582,7902869,2,38315941,4985700,8122870,946800
2021-05-08,268108,71994,84736,0,bund,1790100,0,0,0,30550425,2837576,7987605,2,40106041,4985700,8122870,946800
2021-05-09,194205,56656,34726,0,NA,0,0,0,0,30744630,2894232,8022331,2,40106041,4985700,8122870,946800
2021-05-10,374256,81967,130972,0,impfzentren,0,0,112800,0,31118886,2976199,8153303,2,40106041,4985700,8235670,946800
2021-05-11,828907,80139,176747,0,arztpraxen,1613010,0,880430,0,31947793,3056338,8330050,2,41719051,4985700,9116100,946800
2021-05-12,1096888,91950,225814,0,NA,0,0,0,0,33044681,3148288,8555864,2,41719051,4985700,9116100,946800
2021-05-13,315861,66832,44611,0,NA,0,0,0,0,33360542,3215120,8600475,2,41719051,4985700,9116100,946800
2021-05-14,546818,65022,138872,0,bund,0,0,850,0,33907360,3280142,8739347,2,41719051,4985700,9116950,946800
2021-05-15,279572,60643,56521,0,impfzentren,1825200,550800,0,0,34186932,3340785,8795868,2,43544251,5536500,9116950,946800
2021-05-16,200071,52838,24960,0,bund,35100,15200,0,0,34387003,3393623,8820828,2,43579351,5551700,9116950,946800
2021-05-17,339467,85807,121726,0,impfzentren,0,0,98400,0,34726470,3479430,8942554,2,43579351,5551700,9215350,946800
2021-05-18,591434,101249,173976,0,arztpraxen,1567314,0,754440,0,35317904,3580679,9116530,2,45146665,5551700,9969790,946800
2021-05-19,806298,100369,181991,0,NA,0,0,0,0,36124202,3681048,9298521,2,45146665,5551700,9969790,946800
2021-05-20,686386,96687,156925,0,NA,0,0,0,0,36810588,3777735,9455446,2,45146665,5551700,9969790,946800
2021-05-21,597674,86023,157844,0,impfzentren,0,520800,124800,0,37408262,3863758,9613290,2,45146665,6072500,10094590,946800
2021-05-22,306713,69623,83930,0,NA,0,0,0,0,37714975,3933381,9697220,2,45146665,6072500,10094590,946800
2021-05-23,193211,59491,23926,0,impfzentren,1852109,0,0,0,37908186,3992872,9721146,2,46998774,6072500,10094590,946800
2021-05-23,193211,59491,23926,0,bund,1852109,14400,0,0,38101397,4052363,9745072,2,48850883,6086900,10094590,946800
2021-05-24,236027,61557,20678,0,NA,0,0,0,0,38337424,4113920,9765750,2,48850883,6086900,10094590,946800
2021-05-25,447640,79996,104322,0,arztpraxen,1557786,0,513740,532355,38785064,4193916,9870072,2,50408669,6086900,10608330,1479155
2021-05-26,886842,82670,134316,0,NA,0,0,0,0,39671906,4276586,10004388,2,50408669,6086900,10608330,1479155
2021-05-27,740929,89509,131912,0,NA,0,0,0,0,40412835,4366095,10136300,2,50408669,6086900,10608330,1479155
2021-05-28,605215,86479,130849,0,NA,0,0,0,0,41018050,4452574,10267149,2,50408669,6086900,10608330,1479155
2021-05-29,262598,62662,58046,0,NA,0,0,0,0,41280648,4515236,10325195,2,50408669,6086900,10608330,1479155
2021-05-30,197515,47083,28414,0,impfzentren,1760850,554900,0,0,41478163,4562319,10353609,2,52169519,6641800,10608330,1479155
2021-05-30,197515,47083,28414,0,bund,1760850,554900,0,0,41675678,4609402,10382023,2,53930369,7196700,10608330,1479155
2021-05-31,368062,67767,69822,0,NA,0,0,0,0,42043740,4677169,10451845,2,53930369,7196700,10608330,1479155
2021-06-01,735331,79962,90806,0,arztpraxen,2176062,0,0,714340,42779071,4757131,10542651,2,56106431,7196700,10608330,2193495
2021-06-02,991445,72740,82470,1,NA,0,0,0,0,43770516,4829871,10625121,3,56106431,7196700,10608330,2193495
2021-06-03,476134,64469,50332,1,NA,0,0,0,0,44246650,4894340,10675453,4,56106431,7196700,10608330,2193495
2021-06-04,587038,71380,77106,0,arztpraxen,0,0,384280,0,44833688,4965720,10752559,4,56106431,7196700,10992610,2193495
2021-06-04,587038,71380,77106,0,impfzentren,0,0,384280,0,45420726,5037100,10829665,4,56106431,7196700,11376890,2193495
2021-06-05,271429,67062,44293,0,NA,0,0,0,0,45692155,5104162,10873958,4,56106431,7196700,11376890,2193495
2021-06-06,206116,41074,27290,0,impfzentren,1712880,561180,0,0,45898271,5145236,10901248,4,57819311,7757880,11376890,2193495
2021-06-06,206116,41074,27290,0,bund,1712880,561180,0,0,46104387,5186310,10928538,4,59532191,8319060,11376890,2193495
2021-06-07,403040,85311,72689,0,NA,0,0,0,0,46507427,5271621,11001227,4,59532191,8319060,11376890,2193495
2021-06-08,852912,75618,63152,1,arztpraxen,3367482,0,1020830,520265,47360339,5347239,11064379,5,62899673,8319060,12397720,2713760
2021-06-08,852912,75618,63152,1,betriebe,3367482,0,0,0,48213251,5422857,11127531,6,66267155,8319060,12397720,2713760
2021-06-08,852912,75618,63152,1,impfzentren,0,0,1020830,0,49066163,5498475,11190683,7,66267155,8319060,13418550,2713760
2021-06-09,1183541,87639,64161,1,NA,0,0,0,0,50249704,5586114,11254844,8,66267155,8319060,13418550,2713760
2021-06-10,962556,90085,55986,0,NA,0,0,0,0,51212260,5676199,11310830,8,66267155,8319060,13418550,2713760
2021-06-11,812529,89406,69289,0,NA,0,0,0,0,52024789,5765605,11380119,8,66267155,8319060,13418550,2713760
2021-06-12,285768,72455,43501,1,NA,0,0,0,0,52310557,5838060,11423620,9,66267155,8319060,13418550,2713760
2021-06-13,179970,63595,25859,0,impfzentren,1649700,0,0,0,52490527,5901655,11449479,9,67916855,8319060,13418550,2713760
2021-06-13,179970,63595,25859,0,bund,1649700,13200,0,0,52670497,5965250,11475338,9,69566555,8332260,13418550,2713760
2021-06-14,432868,101480,67574,0,impfzentren,0,537600,0,0,53103365,6066730,11542912,9,69566555,8869860,13418550,2713760
2021-06-15,803959,104837,84819,0,arztpraxen,3051588,0,1137300,235670,53907324,6171567,11627731,9,72618143,8869860,14555850,2949430
2021-06-15,803959,104837,84819,0,betriebe,3051588,0,0,0,54711283,6276404,11712550,9,75669731,8869860,14555850,2949430
2021-06-15,803959,104837,84819,0,impfzentren,0,0,1137300,0,55515242,6381241,11797369,9,75669731,8869860,15693150,2949430
2021-06-16,1108899,106704,97162,0,NA,0,0,0,0,56624141,6487945,11894531,9,75669731,8869860,15693150,2949430
2021-06-17,888220,103743,92375,0,NA,0,0,0,0,57512361,6591688,11986906,9,75669731,8869860,15693150,2949430
2021-06-18,736489,94593,96554,0,NA,0,0,0,0,58248850,6686281,12083460,9,75669731,8869860,15693150,2949430
2021-06-19,273647,82488,50976,0,NA,0,0,0,0,58522497,6768769,12134436,9,75669731,8869860,15693150,2949430
2021-06-20,179045,71523,31866,0,impfzentren,1567800,0,0,0,58701542,6840292,12166302,9,77237531,8869860,15693150,2949430
2021-06-20,179045,71523,31866,0,bund,1567800,0,0,0,58880587,6911815,12198168,9,78805331,8869860,15693150,2949430
2021-06-21,413325,97900,85758,0,impfzentren,0,583200,0,0,59293912,7009715,12283926,9,78805331,9453060,15693150,2949430
2021-06-22,848039,96072,102952,0,arztpraxen,3518118,0,929360,0,60141951,7105787,12386878,9,82323449,9453060,16622510,2949430
2021-06-22,848039,96072,102952,0,impfzentren,0,0,929360,0,60989990,7201859,12489830,9,82323449,9453060,17551870,2949430
2021-06-22,848039,96072,102952,0,betriebe,3518118,0,0,192000,61838029,7297931,12592782,9,85841567,9453060,17551870,3141430
2021-06-23,1093046,96286,115955,0,NA,0,0,0,0,62931075,7394217,12708737,9,85841567,9453060,17551870,3141430
2021-06-24,801396,87501,111030,0,impfzentren,0,0,0,228000,63732471,7481718,12819767,9,85841567,9453060,17551870,3369430
2021-06-25,696795,76708,110166,0,impfzentren,0,613200,0,0,64429266,7558426,12929933,9,85841567,10066260,17551870,3369430
2021-06-26,256158,69167,72682,0,NA,0,0,0,0,64685424,7627593,13002615,9,85841567,10066260,17551870,3369430
2021-06-27,173138,58195,56837,0,impfzentren,1769040,0,0,0,64858562,7685788,13059452,9,87610607,10066260,17551870,3369430
2021-06-27,173138,58195,56837,0,bund,1769040,7200,0,0,65031700,7743983,13116289,9,89379647,10073460,17551870,3369430
2021-06-28,402356,90164,114240,0,NA,0,0,0,0,65434056,7834147,13230529,9,89379647,10073460,17551870,3369430
2021-06-29,688040,93076,133072,0,arztpraxen,3484770,0,479230,0,66122096,7927223,13363601,9,92864417,10073460,18031100,3369430
2021-06-29,688040,93076,133072,0,betriebe,3484770,0,0,0,66810136,8020299,13496673,9,96349187,10073460,18031100,3369430
2021-06-30,773019,94226,136900,0,NA,0,0,0,0,67583155,8114525,13633573,9,96349187,10073460,18031100,3369430
2021-07-01,746915,82465,133000,0,impfzentren,0,0,691200,0,68330070,8196990,13766573,9,96349187,10073460,18722300,3369430
2021-07-02,653149,94043,79379,0,impfzentren,0,0,0,721100,68983219,8291033,13845952,9,96349187,10073460,18722300,4090530
2021-07-03,256412,79406,27204,0,NA,0,0,0,0,69239631,8370439,13873156,9,96349187,10073460,18722300,4090530
2021-07-04,182081,68228,14576,0,impfzentren,1105649,0,0,0,69421712,8438667,13887732,9,97454836,10073460,18722300,4090530
2021-07-05,388963,94027,39629,0,impfzentren,0,876000,0,0,69810675,8532694,13927361,9,97454836,10949460,18722300,4090530
2021-07-06,620610,98562,45446,5,betriebe,2634774,0,0,258360,70431285,8631256,13972807,14,100089610,10949460,18722300,4348890
2021-07-06,620610,98562,45446,5,arztpraxen,2634774,0,2102920,0,71051895,8729818,14018253,19,102724384,10949460,20825220,4348890
2021-07-06,620610,98562,45446,5,impfzentren,0,0,2102920,0,71672505,8828380,14063699,24,102724384,10949460,22928140,4348890
2021-07-07,833570,94941,51411,43,NA,0,0,0,0,72506075,8923321,14115110,67,102724384,10949460,22928140,4348890
2021-07-08,688586,100152,42762,0,NA,0,0,0,0,73194661,9023473,14157872,67,102724384,10949460,22928140,4348890
2021-07-09,597819,98097,43298,1,bund,13710,0,0,0,73792480,9121570,14201170,68,102738094,10949460,22928140,4348890
2021-07-10,229066,84391,21145,6,NA,0,0,0,0,74021546,9205961,14222315,74,102738094,10949460,22928140,4348890
2021-07-11,146134,63861,10294,0,bund,0,0,0,200,74167680,9269822,14232609,74,102738094,10949460,22928140,4349090
2021-07-11,146134,63861,10294,0,impfzentren,1105650,0,0,0,74313814,9333683,14242903,74,103843744,10949460,22928140,4349090
2021-07-12,352330,78843,24082,3,impfzentren,0,1327200,0,0,74666144,9412526,14266985,77,103843744,12276660,22928140,4349090
2021-07-13,632046,77349,34750,0,betriebe,2865282,0,0,129465,75298190,9489875,14301735,77,106709026,12276660,22928140,4478555
2021-07-13,632046,77349,34750,0,arztpraxen,2865282,0,80280,129465,75930236,9567224,14336485,77,109574308,12276660,23008420,4608020
2021-07-14,837024,71820,47254,101,NA,0,0,0,0,76767260,9639044,14383739,178,109574308,12276660,23008420,4608020
2021-07-15,639050,70758,38620,7,NA,0,0,0,0,77406310,9709802,14422359,185,109574308,12276660,23008420,4608020
2021-07-16,544363,64239,32018,18,NA,0,0,0,0,77950673,9774041,14454377,203,109574308,12276660,23008420,4608020
2021-07-17,175514,63405,15671,3,NA,0,0,0,0,78126187,9837446,14470048,206,109574308,12276660,23008420,4608020
2021-07-18,136134,41762,11474,0,impfzentren,1105650,0,0,0,78262321,9879208,14481522,206,110679958,12276660,23008420,4608020
2021-07-19,298561,50660,19815,10,NA,0,0,0,0,78560882,9929868,14501337,216,110679958,12276660,23008420,4608020
2021-07-20,525221,48290,21964,1,betriebe,2106294,0,0,1765,79086103,9978158,14523301,217,112786252,12276660,23008420,4609785
2021-07-20,525221,48290,21964,1,arztpraxen,2106294,0,45750,1765,79611324,10026448,14545265,218,114892546,12276660,23054170,4611550
2021-07-21,675568,46014,22816,0,impfzentren,0,0,0,12000,80286892,10072462,14568081,218,114892546,12276660,23054170,4623550
2021-07-22,548531,43403,18888,4,impfzentren,0,93600,0,0,80835423,10115865,14586969,222,114892546,12370260,23054170,4623550
2021-07-23,494553,42269,18586,3,NA,0,0,0,0,81329976,10158134,14605555,225,114892546,12370260,23054170,4623550
2021-07-24,155035,37578,7749,216,NA,0,0,0,0,81485011,10195712,14613304,441,114892546,12370260,23054170,4623550
2021-07-25,84135,31511,3280,10,impfzentren,1105650,0,0,0,81569146,10227223,14616584,451,115998196,12370260,23054170,4623550
2021-07-26,276558,40010,12426,2,impfzentren,0,888300,0,0,81845704,10267233,14629010,453,115998196,13258560,23054170,4623550
2021-07-27,480765,42298,19926,3,betriebe,1734324,0,0,28660,82326469,10309531,14648936,456,117732520,13258560,23054170,4652210
2021-07-27,480765,42298,19926,3,arztpraxen,1734324,0,38160,28660,82807234,10351829,14668862,459,119466844,13258560,23092330,4680870
2021-07-27,480765,42298,19926,3,impfzentren,0,0,0,28660,83287999,10394127,14688788,462,119466844,13258560,23092330,4709530
2021-07-28,609749,47013,23368,15,impfzentren,0,951600,0,0,83897748,10441140,14712156,477,119466844,14210160,23092330,4709530
2021-07-29,502542,43611,19875,16,NA,0,0,0,0,84400290,10484751,14732031,493,119466844,14210160,23092330,4709530
2021-07-30,421181,45592,17186,42,NA,0,0,0,0,84821471,10530343,14749217,535,119466844,14210160,23092330,4709530
2021-07-31,141242,36101,6019,14,NA,0,0,0,0,84962713,10566444,14755236,549,119466844,14210160,23092330,4709530
2021-08-01,84203,25155,2322,0,impfzentren,883350,0,0,0,85046916,10591599,14757558,549,120350194,14210160,23092330,4709530
2021-08-02,241343,33505,9133,5,impfzentren,0,560400,0,0,85288259,10625104,14766691,554,120350194,14770560,23092330,4709530
2021-08-03,400386,38559,11954,2,betriebe,1437024,0,0,62645,85688645,10663663,14778645,556,121787218,14770560,23092330,4772175
2021-08-03,400386,38559,11954,2,arztpraxen,1437024,0,27140,62645,86089031,10702222,14790599,558,123224242,14770560,23119470,4834820
2021-08-04,515157,36716,11281,6,NA,0,0,0,0,86604188,10738938,14801880,564,123224242,14770560,23119470,4834820
2021-08-05,458139,39855,8003,10,NA,0,0,0,0,87062327,10778793,14809883,574,123224242,14770560,23119470,4834820
2021-08-06,384395,35940,7332,2,NA,0,0,0,0,87446722,10814733,14817215,576,123224242,14770560,23119470,4834820
2021-08-07,139554,31933,1544,242,NA,0,0,0,0,87586276,10846666,14818759,818,123224242,14770560,23119470,4834820
2021-08-08,89584,21831,919,2,impfzentren,877500,0,0,0,87675860,10868497,14819678,820,124101742,14770560,23119470,4834820
2021-08-09,240202,41647,5336,10,impfzentren,0,410400,0,0,87916062,10910144,14825014,830,124101742,15180960,23119470,4834820
2021-08-10,369914,42732,7879,4,betriebe,1185894,0,0,42615,88285976,10952876,14832893,834,125287636,15180960,23119470,4877435
2021-08-10,369914,42732,7879,4,arztpraxen,1185894,0,24330,42615,88655890,10995608,14840772,838,126473530,15180960,23143800,4920050
2021-08-11,472501,47288,9712,3,NA,0,0,0,0,89128391,11042896,14850484,841,126473530,15180960,23143800,4920050
2021-08-12,410917,38405,6983,6,NA,0,0,0,0,89539308,11081301,14857467,847,126473530,15180960,23143800,4920050
2021-08-13,358187,41212,6528,11,NA,0,0,0,0,89897495,11122513,14863995,858,126473530,15180960,23143800,4920050
2021-08-14,146593,32380,1374,26,NA,0,0,0,0,90044088,11154893,14865369,884,126473530,15180960,23143800,4920050
2021-08-15,89428,20860,686,4,impfzentren,508950,0,0,0,90133516,11175753,14866055,888,126982480,15180960,23143800,4920050
2021-08-16,216892,33193,2837,4,arztpraxen,12624,0,0,0,90350408,11208946,14868892,892,126995104,15180960,23143800,4920050
2021-08-16,216892,33193,2837,4,impfzentren,0,87600,0,0,90567300,11242139,14871729,896,126995104,15268560,23143800,4920050
2021-08-17,311651,29741,5786,21,betriebe,881214,0,0,51480,90878951,11271880,14877515,917,127876318,15268560,23143800,4971530
2021-08-17,311651,29741,5786,21,arztpraxen,881214,0,16160,51480,91190602,11301621,14883301,938,128757532,15268560,23159960,5023010
2021-08-17,311651,29741,5786,21,impfzentren,0,0,0,51480,91502253,11331362,14889087,959,128757532,15268560,23159960,5074490
2021-08-18,369480,30368,6055,16,NA,0,0,0,0,91871733,11361730,14895142,975,128757532,15268560,23159960,5074490
2021-08-19,286193,26331,4546,0,NA,0,0,0,0,92157926,11388061,14899688,975,128757532,15268560,23159960,5074490
2021-08-20,292442,23955,5173,2,impfzentren,0,0,-2437600,-73400,92450368,11412016,14904861,977,128757532,15268560,20722360,5001090
2021-08-21,120737,21102,725,4,NA,0,0,0,0,92571105,11433118,14905586,981,128757532,15268560,20722360,5001090
2021-08-22,72625,15515,279,1,impfzentren,421200,0,0,0,92643730,11448633,14905865,982,129178732,15268560,20722360,5001090
2021-08-23,186892,29142,3624,6,NA,0,0,0,0,92830622,11477775,14909489,988,129178732,15268560,20722360,5001090
2021-08-24,252263,25860,3874,120,arztpraxen,689964,0,11980,35735,93082885,11503635,14913363,1108,129868696,15268560,20734340,5036825
2021-08-24,252263,25860,3874,120,impfzentren,0,0,0,35735,93335148,11529495,14917237,1228,129868696,15268560,20734340,5072560
2021-08-24,252263,25860,3874,120,betriebe,689964,0,0,35735,93587411,11555355,14921111,1348,130558660,15268560,20734340,5108295
2021-08-25,296005,24909,3749,3,NA,0,0,0,0,93883416,11580264,14924860,1351,130558660,15268560,20734340,5108295
2021-08-26,257652,22136,3142,109,NA,0,0,0,0,94141068,11602400,14928002,1460,130558660,15268560,20734340,5108295
2021-08-27,210017,22402,2499,24,NA,0,0,0,0,94351085,11624802,14930501,1484,130558660,15268560,20734340,5108295
2021-08-28,106887,15348,535,16,NA,0,0,0,0,94457972,11640150,14931036,1500,130558660,15268560,20734340,5108295
2021-08-29,70426,8414,155,26,impfzentren,152100,0,0,0,94528398,11648564,14931191,1526,130710760,15268560,20734340,5108295
2021-08-30,160523,17134,1890,2,NA,0,0,0,0,94688921,11665698,14933081,1528,130710760,15268560,20734340,5108295
2021-08-31,212014,15822,1661,55,arztpraxen,766716,0,9080,70740,94900935,11681520,14934742,1583,131477476,15268560,20743420,5179035
2021-08-31,212014,15822,1661,55,impfzentren,0,0,0,70740,95112949,11697342,14936403,1638,131477476,15268560,20743420,5249775
2021-08-31,212014,15822,1661,55,betriebe,766716,0,0,0,95324963,11713164,14938064,1693,132244192,15268560,20743420,5249775
2021-09-01,263141,15711,2443,7,NA,0,0,0,0,95588104,11728875,14940507,1700,132244192,15268560,20743420,5249775
2021-09-02,228896,13047,1946,48,NA,0,0,0,0,95817000,11741922,14942453,1748,132244192,15268560,20743420,5249775
2021-09-03,218642,12233,1794,5,impfzentren,0,0,-754900,0,96035642,11754155,14944247,1753,132244192,15268560,19988520,5249775
2021-09-04,89495,8533,330,4,NA,0,0,0,0,96125137,11762688,14944577,1757,132244192,15268560,19988520,5249775
2021-09-05,53694,5693,180,4,impfzentren,81900,0,0,0,96178831,11768381,14944757,1761,132326092,15268560,19988520,5249775
2021-09-06,135131,9736,1841,0,NA,0,0,0,0,96313962,11778117,14946598,1761,132326092,15268560,19988520,5249775
2021-09-07,201500,9276,1959,15,betriebe,816594,0,0,133150,96515462,11787393,14948557,1776,133142686,15268560,19988520,5382925
2021-09-07,201500,9276,1959,15,arztpraxen,816594,0,6530,133150,96716962,11796669,14950516,1791,133959280,15268560,19995050,5516075
2021-09-07,201500,9276,1959,15,impfzentren,0,0,0,133150,96918462,11805945,14952475,1806,133959280,15268560,19995050,5649225
2021-09-08,235367,12151,1296,23,NA,0,0,0,0,97153829,11818096,14953771,1829,133959280,15268560,19995050,5649225
2021-09-09,230335,11450,1155,17,NA,0,0,0,0,97384164,11829546,14954926,1846,133959280,15268560,19995050,5649225
2021-09-10,198850,12485,1305,36,NA,0,0,0,0,97583014,11842031,14956231,1882,133959280,15268560,19995050,5649225
2021-09-11,90685,8816,174,11,NA,0,0,0,0,97673699,11850847,14956405,1893,133959280,15268560,19995050,5649225
2021-09-12,54291,5139,78,5,impfzentren,380250,0,0,0,97727990,11855986,14956483,1898,134339530,15268560,19995050,5649225
2021-09-13,144397,10146,967,12,NA,0,0,0,0,97872387,11866132,14957450,1910,134339530,15268560,19995050,5649225
2021-09-14,214552,8337,1868,4,betriebe,937164,0,0,56230,98086939,11874469,14959318,1914,135276694,15268560,19995050,5705455
2021-09-14,214552,8337,1868,4,arztpraxen,937164,0,4960,56230,98301491,11882806,14961186,1918,136213858,15268560,20000010,5761685
2021-09-14,214552,8337,1868,4,impfzentren,0,0,0,56230,98516043,11891143,14963054,1922,136213858,15268560,20000010,5817915
2021-09-15,257546,11350,1249,29,NA,0,0,0,0,98773589,11902493,14964303,1951,136213858,15268560,20000010,5817915
2021-09-16,249992,9932,1559,6,NA,0,0,0,0,99023581,11912425,14965862,1957,136213858,15268560,20000010,5817915
2021-09-17,221387,10991,905,8,NA,0,0,0,0,99244968,11923416,14966767,1965,136213858,15268560,20000010,5817915
2021-09-18,94990,7624,239,11,NA,0,0,0,0,99339958,11931040,14967006,1976,136213858,15268560,20000010,5817915
2021-09-19,58864,5828,217,5,impfzentren,152100,0,0,0,99398822,11936868,14967223,1981,136365958,15268560,20000010,5817915
2021-09-20,140447,7845,944,5,betriebe,804198,0,0,0,99539269,11944713,14968167,1986,137170156,15268560,20000010,5817915
2021-09-20,140447,7845,944,5,arztpraxen,804198,0,2800,33275,99679716,11952558,14969111,1991,137974354,15268560,20002810,5851190
2021-09-21,215191,7894,1038,5,NA,0,0,0,0,99894907,11960452,14970149,1996,137974354,15268560,20002810,5851190
2021-09-22,253382,9923,863,12,impfzentren,0,0,0,2520,100148289,11970375,14971012,2008,137974354,15268560,20002810,5853710
2021-09-22,253382,9923,863,12,betriebe,0,0,0,2520,100401671,11980298,14971875,2020,137974354,15268560,20002810,5856230
2021-09-23,247347,8387,746,3,NA,0,0,0,0,100649018,11988685,14972621,2023,137974354,15268560,20002810,5856230
2021-09-24,217264,9601,1072,9,NA,0,0,0,0,100866282,11998286,14973693,2032,137974354,15268560,20002810,5856230
2021-09-25,85666,6282,84,5,NA,0,0,0,0,100951948,12004568,14973777,2037,137974354,15268560,20002810,5856230
2021-09-26,48669,3835,33,2,impfzentren,217620,-21300,0,0,101000617,12008403,14973810,2039,138191974,15247260,20002810,5856230
2021-09-27,136549,6263,980,10,betriebe,758406,0,0,32650,101137166,12014666,14974790,2049,138950380,15247260,20002810,5888880
2021-09-27,136549,6263,980,10,arztpraxen,758406,0,2170,32650,101273715,12020929,14975770,2059,139708786,15247260,20004980,5921530
2021-09-28,207747,5744,766,0,NA,0,0,0,0,101481462,12026673,14976536,2059,139708786,15247260,20004980,5921530
2021-09-29,235122,5680,1351,17,impfzentren,0,0,0,5650,101716584,12032353,14977887,2076,139708786,15247260,20004980,5927180
2021-09-30,227565,5850,1260,1,NA,0,0,0,0,101944149,12038203,14979147,2077,139708786,15247260,20004980,5927180
2021-10-01,118391,2960,235,16,NA,0,0,0,0,102062540,12041163,14979382,2093,139708786,15247260,20004980,5927180
2021-10-02,27057,1944,69,2,NA,0,0,0,0,102089597,12043107,14979451,2095,139708786,15247260,20004980,5927180
2021-10-03,11657,1145,33,0,impfzentren,205920,0,0,0,102101254,12044252,14979484,2095,139914706,15247260,20004980,5927180
2021-10-04,86562,3493,732,2,NA,0,0,0,0,102187816,12047745,14980216,2097,139914706,15247260,20004980,5927180
2021-10-05,172636,3480,848,1,arztpraxen,873666,54090,1890,35685,102360452,12051225,14981064,2098,140788372,15301350,20006870,5962865
2021-10-05,172636,3480,848,1,oegd,873666,54090,0,35685,102533088,12054705,14981912,2099,141662038,15355440,20006870,5998550
2021-10-06,194037,4040,366,5,NA,0,0,0,0,102727125,12058745,14982278,2104,141662038,15355440,20006870,5998550
2021-10-07,200230,4299,250,8,NA,0,0,0,0,102927355,12063044,14982528,2112,141662038,15355440,20006870,5998550
2021-10-08,170257,4297,1457,4,NA,0,0,0,0,103097612,12067341,14983985,2116,141662038,15355440,20006870,5998550
2021-10-09,35375,2425,27,0,NA,0,0,0,0,103132987,12069766,14984012,2116,141662038,15355440,20006870,5998550
2021-10-10,14958,941,12,2,NA,0,0,0,0,103147945,12070707,14984024,2118,141662038,15355440,20006870,5998550
2021-10-11,88182,3432,479,26,NA,0,0,0,0,103236127,12074139,14984503,2144,141662038,15355440,20006870,5998550
2021-10-12,168798,5067,783,2,betriebe,0,0,0,41255,103404925,12079206,14985286,2146,141662038,15355440,20006870,6039805
2021-10-12,168798,5067,783,2,arztpraxen,795570,43870,1630,41255,103573723,12084273,14986069,2148,142457608,15399310,20008500,6081060
2021-10-12,168798,5067,783,2,oegd,795570,43870,0,41255,103742521,12089340,14986852,2150,143253178,15443180,20008500,6122315
2021-10-13,195634,5325,244,10,NA,0,0,0,0,103938155,12094665,14987096,2160,143253178,15443180,20008500,6122315
2021-10-14,197525,5299,221,4,NA,0,0,0,0,104135680,12099964,14987317,2164,143253178,15443180,20008500,6122315
2021-10-15,160146,5429,378,2,NA,0,0,0,0,104295826,12105393,14987695,2166,143253178,15443180,20008500,6122315
2021-10-16,36562,2605,38,1,NA,0,0,0,0,104332388,12107998,14987733,2167,143253178,15443180,20008500,6122315
2021-10-17,13528,2167,31,1,NA,0,0,0,0,104345916,12110165,14987764,2168,143253178,15443180,20008500,6122315
2021-10-18,85670,3677,117,9,NA,0,0,0,0,104431586,12113842,14987881,2177,143253178,15443180,20008500,6122315
2021-10-19,168678,4995,215,9,arztpraxen,827274,35770,1340,39770,104600264,12118837,14988096,2186,144080452,15478950,20009840,6162085
2021-10-19,168678,4995,215,9,oegd,827274,35770,1340,39770,104768942,12123832,14988311,2195,144907726,15514720,20011180,6201855
2021-10-20,195363,4835,157,5,NA,0,0,0,0,104964305,12128667,14988468,2200,144907726,15514720,20011180,6201855
2021-10-21,197503,4547,202,18,NA,0,0,0,0,105161808,12133214,14988670,2218,144907726,15514720,20011180,6201855
2021-10-22,150686,5104,259,14,NA,0,0,0,0,105312494,12138318,14988929,2232,144907726,15514720,20011180,6201855
2021-10-23,39037,3037,63,27,NA,0,0,0,0,105351531,12141355,14988992,2259,144907726,15514720,20011180,6201855
2021-10-24,12932,742,7,2,NA,0,0,0,0,105364463,12142097,14988999,2261,144907726,15514720,20011180,6201855
2021-10-25,100334,3726,709,32,impfzentren,0,-2753000,0,0,105464797,12145823,14989708,2293,144907726,12761720,20011180,6201855
2021-10-26,199914,5098,475,5,arztpraxen,1174080,45510,1120,30490,105664711,12150921,14990183,2298,146081806,12807230,20012300,6232345
2021-10-26,199914,5098,475,5,oegd,1174080,45510,1120,30490,105864625,12156019,14990658,2303,147255886,12852740,20013420,6262835
2021-10-27,232540,6644,140,35,NA,0,0,0,0,106097165,12162663,14990798,2338,147255886,12852740,20013420,6262835
2021-10-28,237021,6265,1267,25,NA,0,0,0,0,106334186,12168928,14992065,2363,147255886,12852740,20013420,6262835
2021-10-29,195093,7116,683,12,NA,0,0,0,0,106529279,12176044,14992748,2375,147255886,12852740,20013420,6262835
2021-10-30,47040,3591,162,4,NA,0,0,0,0,106576319,12179635,14992910,2379,147255886,12852740,20013420,6262835
2021-10-31,14841,903,4,0,NA,0,0,0,0,106591160,12180538,14992914,2379,147255886,12852740,20013420,6262835
2021-11-01,59468,3502,228,3,NA,0,0,0,0,106650628,12184040,14993142,2382,147255886,12852740,20013420,6262835
2021-11-02,204514,6605,559,5,arztpraxen,1173618,39520,640,30670,106855142,12190645,14993701,2387,148429504,12892260,20014060,6293505
2021-11-02,204514,6605,559,5,oegd,1173618,39520,0,30670,107059656,12197250,14994260,2392,149603122,12931780,20014060,6324175
2021-11-03,276396,8317,2238,10,NA,0,0,0,0,107336052,12205567,14996498,2402,149603122,12931780,20014060,6324175
2021-11-04,288224,8179,279,32,NA,0,0,0,0,107624276,12213746,14996777,2434,149603122,12931780,20014060,6324175
2021-11-05,243625,9146,130,9,NA,0,0,0,0,107867901,12222892,14996907,2443,149603122,12931780,20014060,6324175
2021-11-06,63132,5462,30,5,NA,0,0,0,0,107931033,12228354,14996937,2448,149603122,12931780,20014060,6324175
2021-11-07,28894,2194,12,4,NA,0,0,0,0,107959927,12230548,14996949,2452,149603122,12931780,20014060,6324175
2021-11-08,162654,7165,525,8,NA,0,0,0,0,108122581,12237713,14997474,2460,149603122,12931780,20014060,6324175
2021-11-09,322823,10061,1040,3,oegd,1578528,54590,0,22220,108445404,12247774,14998514,2463,151181650,12986370,20014060,6346395
2021-11-09,322823,10061,1040,3,arztpraxen,1578528,54590,700,22220,108768227,12257835,14999554,2466,152760178,13040960,20014760,6368615
2021-11-10,382280,11020,394,3,NA,0,0,0,0,109150507,12268855,14999948,2469,152760178,13040960,20014760,6368615
2021-11-11,394522,12258,671,15,NA,0,0,0,0,109545029,12281113,15000619,2484,152760178,13040960,20014760,6368615
2021-11-12,314238,11138,298,12,NA,0,0,0,0,109859267,12292251,15000917,2496,152760178,13040960,20014760,6368615
2021-11-13,95479,5669,22,10,NA,0,0,0,0,109954746,12297920,15000939,2506,152760178,13040960,20014760,6368615
2021-11-14,45307,2627,71,0,NA,0,0,0,0,110000053,12300547,15001010,2506,152760178,13040960,20014760,6368615
2021-11-15,231334,9869,545,8,NA,0,0,0,0,110231387,12310416,15001555,2514,152760178,13040960,20014760,6368615
2021-11-16,454932,12577,460,10,arztpraxen,2520066,86150,580,22060,110686319,12322993,15002015,2524,155280244,13127110,20015340,6390675
2021-11-16,454932,12577,460,10,oegd,2520066,86150,0,22060,111141251,12335570,15002475,2534,157800310,13213260,20015340,6412735
2021-11-16,454932,12577,460,10,betriebe,2520066,0,0,0,111596183,12348147,15002935,2544,160320376,13213260,20015340,6412735
2021-11-17,530901,16251,77,66,NA,0,0,0,0,112127084,12364398,15003012,2610,160320376,13213260,20015340,6412735
2021-11-18,557354,18119,450,19,NA,0,0,0,0,112684438,12382517,15003462,2629,160320376,13213260,20015340,6412735
2021-11-19,514018,20039,789,24,NA,0,0,0,0,113198456,12402556,15004251,2653,160320376,13213260,20015340,6412735
2021-11-20,197258,12989,113,96,NA,0,0,0,0,113395714,12415545,15004364,2749,160320376,13213260,20015340,6412735
2021-11-21,82672,8700,391,10,NA,0,0,0,0,113478386,12424245,15004755,2759,160320376,13213260,20015340,6412735
2021-11-22,384031,22899,411,66,NA,0,0,0,0,113862417,12447144,15005166,2825,160320376,13213260,20015340,6412735
2021-11-23,665084,35247,159,223,betriebe,6449100,0,0,0,114527501,12482391,15005325,3048,166769476,13213260,20015340,6412735
2021-11-23,665084,35247,159,223,arztpraxen,6449100,239170,40,62570,115192585,12517638,15005484,3271,173218576,13452430,20015380,6475305
2021-11-23,665084,35247,159,223,oegd,6449100,239170,0,62570,115857669,12552885,15005643,3494,179667676,13691600,20015380,6537875
2021-11-24,827843,49759,129,247,NA,0,0,0,0,116685512,12602644,15005772,3741,179667676,13691600,20015380,6537875
2021-11-25,812128,53713,617,53,NA,0,0,0,0,117497640,12656357,15006389,3794,179667676,13691600,20015380,6537875
2021-11-26,756585,63889,395,94,NA,0,0,0,0,118254225,12720246,15006784,3888,179667676,13691600,20015380,6537875
2021-11-27,483101,71993,60,35,NA,0,0,0,0,118737326,12792239,15006844,3923,179667676,13691600,20015380,6537875
2021-11-28,155864,40707,426,9,NA,0,0,0,0,118893190,12832946,15007270,3932,179667676,13691600,20015380,6537875
2021-11-29,511541,102381,734,10,NA,0,0,0,0,119404731,12935327,15008004,3942,179667676,13691600,20015380,6537875
2021-11-30,668575,234414,539,43,betriebe,0,3649710,0,98490,120073306,13169741,15008543,3985,179667676,17341310,20015380,6636365
2021-11-30,668575,234414,539,43,arztpraxen,3816612,3649710,0,98490,120741881,13404155,15009082,4028,183484288,20991020,20015380,6734855
2021-11-30,668575,234414,539,43,oegd,3816612,3649710,0,98490,121410456,13638569,15009621,4071,187300900,24640730,20015380,6833345
2021-12-01,743598,360009,215,33,NA,0,0,0,0,122154054,13998578,15009836,4104,187300900,24640730,20015380,6833345
2021-12-02,705176,375418,560,28,NA,0,0,0,0,122859230,14373996,15010396,4132,187300900,24640730,20015380,6833345
2021-12-03,672881,374486,107,23,NA,0,0,0,0,123532111,14748482,15010503,4155,187300900,24640730,20015380,6833345
2021-12-04,411584,400695,282,14,NA,0,0,0,0,123943695,15149177,15010785,4169,187300900,24640730,20015380,6833345
2021-12-05,125124,146057,15,12,NA,0,0,0,0,124068819,15295234,15010800,4181,187300900,24640730,20015380,6833345
2021-12-06,393830,334008,289,19,NA,0,0,0,0,124462649,15629242,15011089,4200,187300900,24640730,20015380,6833345
2021-12-07,580116,487016,764,10,betriebe,3032460,0,0,0,125042765,16116258,15011853,4210,190333360,24640730,20015380,6833345
2021-12-07,580116,487016,764,10,arztpraxen,3032460,5597360,0,206450,125622881,16603274,15012617,4220,193365820,30238090,20015380,7039795
2021-12-07,580116,487016,764,10,oegd,3032460,5597360,0,206450,126202997,17090290,15013381,4230,196398280,35835450,20015380,7246245
2021-12-08,661284,597302,426,12,NA,0,0,0,0,126864281,17687592,15013807,4242,196398280,35835450,20015380,7246245
2021-12-09,644716,574962,459,24,NA,0,0,0,0,127508997,18262554,15014266,4266,196398280,35835450,20015380,7246245
2021-12-10,613515,572601,529,18,NA,0,0,0,0,128122512,18835155,15014795,4284,196398280,35835450,20015380,7246245
2021-12-11,407595,556219,416,18,NA,0,0,0,0,128530107,19391374,15015211,4302,196398280,35835450,20015380,7246245
2021-12-12,119302,185949,15,5,NA,0,0,0,0,128649409,19577323,15015226,4307,196398280,35835450,20015380,7246245
2021-12-13,371854,399751,418,40,NA,0,0,0,0,129021263,19977074,15015644,4347,196398280,35835450,20015380,7246245
2021-12-14,588897,502863,454,18,arztpraxen,6907398,4024780,0,111720,129610160,20479937,15016098,4365,203305678,39860230,20015380,7357965
2021-12-14,588897,502863,454,18,oegd,6907398,4024780,0,111720,130199057,20982800,15016552,4383,210213076,43885010,20015380,7469685
2021-12-15,880394,696277,796,18,NA,0,0,0,0,131079451,21679077,15017348,4401,210213076,43885010,20015380,7469685
2021-12-16,744814,569264,651,13,NA,0,0,0,0,131824265,22248341,15017999,4414,210213076,43885010,20015380,7469685
2021-12-17,656287,494496,489,12,NA,0,0,0,0,132480552,22742837,15018488,4426,210213076,43885010,20015380,7469685
2021-12-18,424059,418952,309,7,NA,0,0,0,0,132904611,23161789,15018797,4433,210213076,43885010,20015380,7469685
2021-12-19,148370,162015,507,6,NA,0,0,0,0,133052981,23323804,15019304,4439,210213076,43885010,20015380,7469685
